11111100000000000000000001111
60000200000000000000000000111
11111011111111111111111110111
11111011111111111111111110111
11111052111111111111111000111
11111110000000002000000011111
11111111101111115111111111111
11111111101111110111111111111
11111111101111110111111111111
11111111101111110111111111111
11111111101111114000000500007
11111111101111110111111111111
11111111101111110111111111111